6
05x05_01
05x05_02
05x05_03
05x05_04
10x10_01
10x10_02
10x10_03