5
05x05_01
05x05_02
05x05_03
10x10_01
15x15_01
