9
05x05_01
05x05_02
05x05_03
05x07_01
05x07_02
05x07_03
10x10_01
10x10_02
10x10_03
