9
05x05_01 
05x07_02
07x05_02
10x10_01
10x10_02
10x10_03
