9
05x05_01 
05x07_01
07x05_01
10x10_01
10x10_02
10x10_03
