9
05x05_01 
05x07_01
07x05_01
10x10_01
10x10_02
10x10_03
05x05_05
15x15_01
15x15_02
